111111111111111111111111111111
100000000000000000000000000001
100000000000000000000000000001
1000000011100000E1111111000001
100000011100000000000001110001
100P00111000000000000000111001
100001110000000000000000111001
100011100000000000000001110001
1001110000111000C0000111000001
101111111111111000011100000001
101111111111111000111000000001
10000C000011100001111111111001
100000000011100011111111111001
100000000000000000000000000001
1000000000000000C0000000000001
111111111111111111111111111111