11111111111111
10000000000001
10000000000001
1P0000000C00E1
11111111111111